Catherine	Ross
Jasmine	Barnes
Ned	Henderson
Rubie	Bennett
Evelyn	Barnes
Olivia	Barnes
Fenton	Campbell
Max	Mitchell
Garry	Kelley
Daryl	Harper
Tara	Grant
Luke	Craig
Lilianna	Allen
Heather	Tucker
Julia	Morris
Thomas	Chapman
Sofia	Grant
Mary	West
Chloe	Miller
Alford	Spencer
Fenton	Murphy
Darcy	Casey
Myra	Hunt
Max	Jones
Sarah	Cunningham
Sydney	Miller
Samantha	Miller
Fenton	Foster
Carina	Montgomery
Eric	Tucker
James	Kelly
Sawyer	Edwards
Alisa	Anderson
Madaline	Carter
Sydney	Evans
Owen	Ellis
Andrew	Murray
Julian	Thomas
Agata	Murray
Alen	Ross
Garry	Chapman
Rafael	Kelley
Max	Evans
Lenny	Evans
Belinda	Evans
Lucas	Alexander
Steven	Walker
Daniel	Jones
Carlos	Bailey
Kimberly	Parker